................................X
NNNNNNNXXXXXXX..................X
NNNNNNNXC....X.......T..........X
NNNNNNNX.....X..................X
XXXXXXXXXXX..X..................X
.E.....E.......P...............EX
................................X
................................X
................................X
................................X
................................X
................................X
................................X
................................X
................................X
................................X
................................X
................................X
................................X
................................X
................................X
................................X
................................X
................................X
................................X
................................X
................................X
................................X
................................X
................................X
................................X
................................X
XXXXXXXXXXXXXXXXXXXXXXXXXXXXXXXXX
