................................X
NNNNNNNXXXXXXX..................X
NNNNNNNXC....X.......T..........X
NNNNNNNX.....X..................X
XXXXXXXXXXX..X..................X
...............P...............EX
................................X
.........................E......X
......E.........................X
.............E..................X
.E..............................X
.....................E..........X
........E.......................X
................................X
................................X
................................X
................................X
..E.............................X
................................X
...................E............X
................................X
................................X
................................X
................................X
................................X
................................X
................................X
................................X
................................X
................................X
................................X
................................X
XXXXXXXXXXXXXXXXXXXXXXXXXXXXXXXXX
