C...........X.....................................................X
C...P...H...D.....................................................X
.....x......X.....................................................X
............X.....................................................X
............X.....................................................X
XXXXDXXXXXXXX.....................................................X
..................................................................X
..................................................................X
..................................................................X
..................................................................X
..................................................................X
..................................................................X
..................................................................X
..................................................................X
..................................................................X
..................................................................X
..................................................................X
..................................................................X
..................................................................X
..................................................................X
..................................................................X
..................................................................X
..................................................................X
..................................................................X
..................................................................X
..................................................................X
..................................................................X
..................................................................X
..................................................................X
..................................................................X
..................................................................X
..................................................................X
..................................................................X
XXXXXXXXXXXXXXXXXXXXXXXXXXXXXXXXXXXXXXXXXXXXXXXXXXXXXXXXXXXXXXXXXXX
