................................X
.......XXXXXXX..................X
.......XC....X.......T..........X
.......X.....X..................X
XXXXXXXXXXX..X..................X
...............P...............EX
................................X
.........................E......X
......E.........................X
................................X
................................X
................................X
................................X
................................X
................................X
................................X
................................X
................................X
................................X
................................X
................................X
................................X
................................X
................................X
................................X
................................X
................................X
................................X
................................X
................................X
................................X
................................X
XXXXXXXXXXXXXXXXXXXXXXXXXXXXXXXXX
