.......H....X........................X
....P...........................X
.....................T....H.....X
............X...................X
XXXX..XXXXXXX...................X
.E.....E.......................EX
................................X
................................X
................................X
................................X
................................X
................................X
................................X
................................X
................................X
................................X
................................X
................................X
................................X
................................X
................................X
................................X
................................X
................................X
................................X
................................X
................................X
................................X
................................X
................................X
................................X
................................X
XXXXXXXXXXXXXXXXXXXXXXXXXXXXXXXXX
