C......H....X........................X
C...P.......D...................X
............X........T....H.....X
............X...................X
XXXXDXXXXXXXX...................X
.E.....E.......................EX
................................X
................................X
................................X
................................X
................................X
................................X
................................X
................................X
................................X
................................X
................................X
................................X
................................X
................................X
................................X
................................X
................................X
................................X
................................X
................................X
................................X
................................X
................................X
................................X
................................X
................................X
XXXXXXXXXXXXXXXXXXXXXXXXXXXXXXXXX
