C......H....X.....................................................X
C...P.......D.....................................................X
.....x......X........T....H.......................................X
............X.....................................................X
............X.....................................................X
XXXXDXXXXXXXX.....................................................X
..................................................................X
..................................................................X
..................................................................X
..................................................................X
..................................................................X
..................................................................X
..................................................................X
..................................................................X
..................................................................X
..................................................................X
..................................................................X
..................................................................X
..................................................................X
..................................................................X
..................................................................X
..................................................................X
..................................................................X
..................................................................X
..................................................................X
..................................................................X
..................................................................X
..................................................................X
..................................................................X
..................................................................X
..................................................................X
..................................................................X
..................................................................X
XXXXXXXXXXXXXXXXXXXXXXXXXXXXXXXXXXXXXXXXXXXXXXXXXXXXXXXXXXXXXXXXXXX
