................................X
.......XXXXXXX..................X
.......XC....X.......T..........X
.......X.....X..................X
XXXXXXXXXXX..X..................X
.E.....E.......................EX
................................X
................................X
................................X
........................P.......X
................................X
................................X
................................X
................................X
................................X
................................X
................................X
................................X
................................X
................................X
................................X
................................X
................................X
................................X
................................X
................................X
................................X
................................X
................................X
................................X
................................X
................................X
XXXXXXXXXXXXXXXXXXXXXXXXXXXXXXXXX
