................................X
.......XXXXXXX..................X
.......XC....X.......T..........X
.......X.....X..................X
XXXXXXXXXXX..X..................X
.E.....E.......P...............EX
................................X
................................X
................................X
................................X
................................X
................................X
................................X
................................X
................................X
................................X
................................X
................................X
................................X
................................X
................................X
................................X
................................X
................................X
................................X
................................X
................................X
................................X
................................X
................................X
................................X
................................X
XXXXXXXXXXXXXXXXXXXXXXXXXXXXXXXXX
